1111111111111111111111111
1P00100000C0000000C001001
1000000000001010000000CC1
1C000001000011100000C0111
1C000000000011100000E1001
1111111111111111111111111
