11111111111111111111111111111111111111111111111111111
1P00100000C000000000000000000011110000000001000000001
10000000000000000000000000000000000000000000000000001
1C000000000000000000000000000000000000000111111111111
11111111111000000000000011111111111111111111111000001
10000000000000000000000000000111111111000000000111111
11111111111111111111111111000111111111111111111111111
10C0000000000000000000000000000000000000000000000E001
11111111111111111111111111111111111111111111111111111
