11111111111111111111111111
1E1P0101C00000000000000CC1
10100101011111000000011CC1
1010010101CCC1000000011111
1C100111010001000000011111
10100000010001000000000001
10111111111011000000000001
101001CCCCCCC1111111111101
101001CCCCCCCCCCCCC1000101
101001CCCCCCCCCCCCC1000101
101001CCCCCCCCCCCCC1010101
101001CCCCCCCCCC1111010101
101001CCCCCCCCCC0000010101
101001CCCCCCCC111111010101
101001CCCCCCCC1CCCC1010101
101001CCCCCCCC1CCCC1010101
101001CCCCCCCC1CCCC1010101
101000CCCCCCCC1CCCC1010101
101001CCCCCCCC1CCCC101C101
101001CCCCCCCC1CCCC1011101
100001CCCCCCCCCCCCC1000001
11111111111111111111111111
