1111111111111111111111
1P00100000C00000000001
1000000000001010000001
1C000000000011100000E1
1111111111111111111111
