11111
1P001
10001
1C1C1
10001
10001
10001
11011
11011
11011
11011
11011
10001
1CCC1
10001
11E11
11111
