11111111111111111111111111111111111111111111111111111111111111111
100000000000000000000000000000P0000000000000000000000000000000001
10000000000000000000000000000000000000000000000000000000000000001
1CCCCCCCCCCCCCCCCCCCCCCCCCCCCCCCCCCCCCCCCCCCCCCCCCCCCCCCCCCCCCCC1
10000000000000000000000000000000000000000000000000000000000000001
11111111111111111111111111111110111111111111111111111111111111111
10000000000000000000000000000000000000000000000000000000000000001
10000000000000000000000000000000000000000000000000000000000000001
10000000000000000000000000000000000000000000000000000000000000001
10000000000000000000000000000000000000000000000000000000000000001
10000000000000000000000000000000000000000000000000000000000000001
10000000000000000000000000000000000000000000000000000000000000001
10000000000000000000000000000000000000000000000000000000000000001
10000000000000000000000000000000000000000000000000000000000000001
1C0000000000000000000000000000000000000000000000000000000000000C1
1000000000000000000000000000000000000000000000E000000000000000001
11111111111111111111111111111111111111111111111111111111111111111
