1111111111111111111111111111111111111111111
1000000000000001000000011111111110000000001
1000000000000010000000000000001000000000001
1000P00000000100C00000000000100000000000001
1000000000001000000000000010000000000000001
1000000000011111111100001000000000000000001
1000000000000000100000100000000000000E00001
1000000000000000100000111111111110000000001
1000000000000000000000000000000000000000001
1000000000000000000000000000000000000000001
1111111111111111111111111111111111111111111
