111111111111111111111111111111111111111
11111111111111111C000000001111111111111
111111111111111111011111001111111111111
111111111100000111011111011111111111111
11111P111101110000010000011111111111111
111100111001111111110111111111111111111
1111100000111111111101110000000000000C1
111111111111111111000111011111101111111
111111111111111110011111011111101111111
111111000000110000111111011111101111111
111100011110010111111111011111101111111
1C0000000011000111100000011111101111111
111111111011111111101111111111101111111
111111111000000000001111111111101111111
111111111111111111111111111111101111111
1111111111111111111111111111111E1111111
111111111111111111111111111111111111111
