1111111111111111111111111111
1EEEEEEEEEEE0000000000000001
1000C00000000000000000011111
1111110000000000000000000C01
100C000000000001111111111111
11111111111111000000000000C1
100000C000000000011111111111
1111111111100000000C00000001
10000C0000000001111111111111
1111111111111000000000C00001
1000000C00000000001111111111
1111111111111100000000C00001
10000C0000000000111111111111
1111111000000000000000C00001
1000000000000000000000111111
1111111111111011111111111111
1111111111111011111111111111
1111111111111011111111111111
1111111111111011111111111111
1111111111111011111111111111
1111111111111011111111111111
1111111111111011111111111111
1111111111111P11111111111111
1111111111111111111111111111
