111111111111111111111111111111111
100000000000000000E00P00000000001
100000000000000000000000000000001
111111111111111111111111111111101
100000000CCCCCCCCCCCCCCCCCCCCC101
100000000000000000000000000000101
1CCCC0000000000000000000000000001
111111111111111111111111111111111
